Language,Location,Filename,Lines,Code,Comments,Blanks,Complexity
gitignore,.gitignore,.gitignore,4,3,0,1,0
YAML,_config.yml,_config.yml,1,1,0,0,0
Markdown,V3.md,V3.md,7239,5345,0,1894,0
Markdown,README.md,README.md,7406,5505,0,1901,0
Markdown,md/223.md,223.md,9,7,0,2,0
Markdown,md/155.md,155.md,9,7,0,2,0
Markdown,md/196.md,196.md,9,7,0,2,0
Markdown,md/104.md,104.md,20,16,0,4,0
Markdown,md/18.md,18.md,29,25,0,4,0
Markdown,md/213.md,213.md,9,7,0,2,0
Markdown,md/1.md,1.md,27,20,0,7,0
Markdown,md/120.md,120.md,52,40,0,12,0
Markdown,md/59.md,59.md,49,39,0,10,0
Markdown,md/19.md,19.md,23,18,0,5,0
Markdown,md/100.md,100.md,49,35,0,14,0
Markdown,md/115.md,115.md,21,16,0,5,0
Markdown,md/144.md,144.md,9,7,0,2,0
Markdown,md/48.md,48.md,16,12,0,4,0
Markdown,md/226.md,226.md,9,7,0,2,0
Markdown,md/151.md,151.md,9,7,0,2,0
Markdown,md/145.md,145.md,9,7,0,2,0
Markdown,md/182.md,182.md,9,7,0,2,0
Markdown,md/207.md,207.md,9,7,0,2,0
Markdown,md/227.md,227.md,9,7,0,2,0
Markdown,md/233.md,233.md,9,7,0,2,0
Markdown,md/165.md,165.md,9,7,0,2,0
Markdown,md/192.md,192.md,9,7,0,2,0
Markdown,md/186.md,186.md,9,7,0,2,0
Markdown,md/49.md,49.md,16,12,0,4,0
Markdown,md/203.md,203.md,9,7,0,2,0
Markdown,md/217.md,217.md,9,7,0,2,0
Markdown,md/79.md,79.md,18,14,0,4,0
Markdown,md/171.md,171.md,9,7,0,2,0
Markdown,md/175.md,175.md,9,7,0,2,0
Markdown,md/130.md,130.md,32,25,0,7,0
Markdown,md/161.md,161.md,9,7,0,2,0
Markdown,md/134.md,134.md,26,21,0,5,0
Markdown,md/124.md,124.md,35,27,0,8,0
Markdown,md/114.md,114.md,22,18,0,4,0
Markdown,md/28.md,28.md,35,23,0,12,0
Markdown,md/38.md,38.md,22,18,0,4,0
Markdown,md/69.md,69.md,18,14,0,4,0
Markdown,md/5.md,5.md,18,15,0,3,0
Markdown,md/121.md,121.md,59,39,0,20,0
Markdown,md/170.md,170.md,9,7,0,2,0
Markdown,md/110.md,110.md,55,47,0,8,0
Markdown,md/183.md,183.md,9,7,0,2,0
Markdown,md/212.md,212.md,9,7,0,2,0
Markdown,md/202.md,202.md,9,7,0,2,0
Markdown,md/193.md,193.md,9,7,0,2,0
Markdown,md/160.md,160.md,9,7,0,2,0
Markdown,md/154.md,154.md,9,7,0,2,0
Markdown,md/131.md,131.md,33,27,0,6,0
Markdown,md/58.md,58.md,18,12,0,6,0
Markdown,md/29.md,29.md,23,17,0,6,0
Markdown,md/105.md,105.md,81,68,0,13,0
Markdown,md/174.md,174.md,9,7,0,2,0
Markdown,md/125.md,125.md,23,18,0,5,0
Markdown,md/78.md,78.md,25,20,0,5,0
Markdown,md/216.md,216.md,9,7,0,2,0
Markdown,md/187.md,187.md,9,7,0,2,0
Markdown,md/140.md,140.md,50,37,0,13,0
Markdown,md/111.md,111.md,23,18,0,5,0
Markdown,md/222.md,222.md,9,7,0,2,0
Markdown,md/232.md,232.md,9,7,0,2,0
Markdown,md/101.md,101.md,35,26,0,9,0
Markdown,md/150.md,150.md,9,7,0,2,0
Markdown,md/197.md,197.md,9,7,0,2,0
Markdown,md/206.md,206.md,9,7,0,2,0
Markdown,md/164.md,164.md,9,7,0,2,0
Markdown,md/4.md,4.md,17,15,0,2,0
Markdown,md/135.md,135.md,21,19,0,2,0
Markdown,md/68.md,68.md,15,12,0,3,0
Markdown,md/229.md,229.md,9,7,0,2,0
Markdown,md/39.md,39.md,23,19,0,4,0
Markdown,md/141.md,141.md,79,65,0,14,0
Markdown,md/47.md,47.md,19,16,0,3,0
Markdown,md/80.md,80.md,17,14,0,3,0
Markdown,md/16.md,16.md,21,15,0,6,0
Markdown,md/63.md,63.md,50,40,0,10,0
Markdown,md/188.md,188.md,9,7,0,2,0
Markdown,md/84.md,84.md,26,22,0,4,0
Markdown,md/22.md,22.md,48,34,0,14,0
Markdown,md/73.md,73.md,18,14,0,4,0
Markdown,md/219.md,219.md,9,7,0,2,0
Markdown,md/90.md,90.md,19,12,0,7,0
Markdown,md/57.md,57.md,23,19,0,4,0
Markdown,md/32.md,32.md,16,13,0,3,0
Markdown,md/77.md,77.md,21,15,0,6,0
Markdown,md/26.md,26.md,76,54,0,22,0
Markdown,md/198.md,198.md,9,7,0,2,0
Markdown,md/56.md,56.md,20,17,0,3,0
Markdown,md/128.md,128.md,37,27,0,10,0
Markdown,md/95.md,95.md,78,52,0,26,0
Markdown,md/179.md,179.md,9,7,0,2,0
Markdown,md/24.md,24.md,22,17,0,5,0
Markdown,md/75.md,75.md,22,16,0,6,0
Markdown,md/86.md,86.md,24,17,0,7,0
Markdown,md/41.md,41.md,23,18,0,5,0
Markdown,md/10.md,10.md,14,11,0,3,0
Markdown,md/51.md,51.md,29,25,0,4,0
Markdown,md/9.md,9.md,20,16,0,4,0
Markdown,md/218.md,218.md,9,7,0,2,0
Markdown,md/199.md,199.md,9,7,0,2,0
Markdown,md/189.md,189.md,9,7,0,2,0
Markdown,md/23.md,23.md,15,11,0,4,0
Python,md/batch.py,batch.py,47,34,7,6,5
Markdown,md/81.md,81.md,16,13,0,3,0
Markdown,md/72.md,72.md,20,15,0,5,0
Markdown,md/228.md,228.md,9,7,0,2,0
Markdown,md/12.md,12.md,17,13,0,4,0
Markdown,md/42.md,42.md,31,24,0,7,0
Markdown,md/27.md,27.md,71,50,0,21,0
Markdown,md/46.md,46.md,81,55,0,26,0
Markdown,md/17.md,17.md,15,12,0,3,0
Markdown,md/208.md,208.md,9,7,0,2,0
Markdown,md/62.md,62.md,38,29,0,9,0
Markdown,md/43.md,43.md,16,12,0,4,0
Markdown,md/13.md,13.md,13,11,0,2,0
Markdown,md/76.md,76.md,23,17,0,6,0
Markdown,md/37.md,37.md,42,38,0,4,0
Markdown,md/66.md,66.md,19,14,0,5,0
Markdown,md/91.md,91.md,33,22,0,11,0
Markdown,md/33.md,33.md,52,42,0,10,0
Markdown,md/52.md,52.md,15,12,0,3,0
Markdown,md/209.md,209.md,9,7,0,2,0
Markdown,md/53.md,53.md,49,43,0,6,0
Markdown,md/67.md,67.md,22,17,0,5,0
Markdown,md/36.md,36.md,33,28,0,5,0
Markdown,md/94.md,94.md,24,18,0,6,0
Markdown,md/96.md,96.md,50,34,0,16,0
Markdown,md/65.md,65.md,17,12,0,5,0
Markdown,md/169.md,169.md,9,7,0,2,0
Markdown,md/34.md,34.md,26,23,0,3,0
Markdown,md/118.md,118.md,32,23,0,9,0
Markdown,md/149.md,149.md,9,7,0,2,0
Markdown,md/14.md,14.md,16,12,0,4,0
Markdown,md/85.md,85.md,25,20,0,5,0
Markdown,md/138.md,138.md,94,67,0,27,0
Markdown,md/45.md,45.md,28,22,0,6,0
Markdown,md/71.md,71.md,26,21,0,5,0
Markdown,md/20.md,20.md,19,14,0,5,0
Markdown,md/82.md,82.md,27,23,0,4,0
Markdown,md/30.md,30.md,16,12,0,4,0
Markdown,md/92.md,92.md,44,37,0,7,0
Markdown,md/55.md,55.md,20,15,0,5,0
Markdown,md/108.md,108.md,34,24,0,10,0
Markdown,md/159.md,159.md,9,7,0,2,0
Markdown,md/61.md,61.md,17,14,0,3,0
Markdown,md/83.md,83.md,27,24,0,3,0
Markdown,md/54.md,54.md,70,56,0,14,0
Markdown,md/25.md,25.md,13,10,0,3,0
Markdown,md/50.md,50.md,17,13,0,4,0
Markdown,md/87.md,87.md,16,12,0,4,0
Markdown,md/119.md,119.md,41,29,0,12,0
Markdown,md/173.md,173.md,9,7,0,2,0
Markdown,md/163.md,163.md,9,7,0,2,0
Markdown,md/132.md,132.md,32,23,0,9,0
Markdown,md/190.md,190.md,9,7,0,2,0
Markdown,md/201.md,201.md,9,7,0,2,0
Markdown,md/106.md,106.md,40,33,0,7,0
Markdown,md/157.md,157.md,9,7,0,2,0
Markdown,md/3.md,3.md,19,16,0,3,0
Markdown,md/122.md,122.md,61,44,0,17,0
Markdown,md/88.md,88.md,20,15,0,5,0
Markdown,md/148.md,148.md,9,7,0,2,0
Markdown,md/184.md,184.md,9,7,0,2,0
Markdown,md/158.md,158.md,9,7,0,2,0
Markdown,md/215.md,215.md,9,7,0,2,0
Markdown,md/177.md,177.md,9,7,0,2,0
Markdown,md/74.md,74.md,23,18,0,5,0
Markdown,md/15.md,15.md,20,15,0,5,0
Markdown,md/109.md,109.md,22,16,0,6,0
Markdown,md/8.md,8.md,14,11,0,3,0
Markdown,md/40.md,40.md,25,20,0,5,0
Markdown,md/93.md,93.md,48,32,0,16,0
Markdown,md/44.md,44.md,46,35,0,11,0
Markdown,md/11.md,11.md,14,11,0,3,0
Markdown,md/97.md,97.md,27,22,0,5,0
Markdown,md/98.md,98.md,23,17,0,6,0
Markdown,md/129.md,129.md,51,40,0,11,0
Markdown,md/70.md,70.md,16,12,0,4,0
Markdown,md/60.md,60.md,19,14,0,5,0
Markdown,md/7.md,7.md,14,11,0,3,0
Markdown,md/89.md,89.md,33,24,0,9,0
Markdown,md/214.md,214.md,9,7,0,2,0
Markdown,md/176.md,176.md,9,7,0,2,0
Markdown,md/127.md,127.md,19,13,0,6,0
Markdown,md/220.md,220.md,9,7,0,2,0
Markdown,md/185.md,185.md,9,7,0,2,0
Markdown,md/113.md,113.md,14,11,0,3,0
Markdown,md/21.md,21.md,27,24,0,3,0
Markdown,md/64.md,64.md,30,22,0,8,0
Markdown,md/178.md,178.md,9,7,0,2,0
Markdown,md/31.md,31.md,16,12,0,4,0
Markdown,md/142.md,142.md,9,7,0,2,0
Markdown,md/152.md,152.md,9,7,0,2,0
Markdown,md/103.md,103.md,18,15,0,3,0
Markdown,md/230.md,230.md,9,7,0,2,0
Markdown,md/166.md,166.md,9,7,0,2,0
Markdown,md/195.md,195.md,9,7,0,2,0
Markdown,md/204.md,204.md,9,7,0,2,0
Markdown,md/99.md,99.md,66,46,0,20,0
Markdown,md/6.md,6.md,19,15,0,4,0
Markdown,md/137.md,137.md,97,75,0,22,0
Markdown,md/224.md,224.md,9,7,0,2,0
Markdown,md/146.md,146.md,9,7,0,2,0
Markdown,md/225.md,225.md,9,7,0,2,0
Markdown,md/153.md,153.md,9,7,0,2,0
Markdown,md/168.md,168.md,9,7,0,2,0
Markdown,md/167.md,167.md,9,7,0,2,0
Markdown,md/136.md,136.md,46,38,0,8,0
Markdown,md/126.md,126.md,18,14,0,4,0
Markdown,md/139.md,139.md,35,28,0,7,0
Markdown,md/35.md,35.md,23,19,0,4,0
Markdown,md/147.md,147.md,9,7,0,2,0
Markdown,md/112.md,112.md,19,14,0,5,0
Markdown,md/102.md,102.md,62,35,0,27,0
Markdown,md/156.md,156.md,9,7,0,2,0
Markdown,md/116.md,116.md,17,13,0,4,0
Markdown,md/2.md,2.md,25,21,0,4,0
Markdown,md/211.md,211.md,9,7,0,2,0
Markdown,md/231.md,231.md,9,7,0,2,0
Markdown,md/221.md,221.md,9,7,0,2,0
Markdown,md/180.md,180.md,9,7,0,2,0
Markdown,md/205.md,205.md,9,7,0,2,0
Markdown,md/143.md,143.md,9,7,0,2,0
Markdown,md/123.md,123.md,61,46,0,15,0
Markdown,md/191.md,191.md,9,7,0,2,0
Markdown,md/133.md,133.md,45,39,0,6,0
Markdown,md/172.md,172.md,9,7,0,2,0
Markdown,md/162.md,162.md,9,7,0,2,0
Markdown,md/181.md,181.md,9,7,0,2,0
Markdown,md/210.md,210.md,9,7,0,2,0
Markdown,md/200.md,200.md,9,7,0,2,0
Markdown,md/194.md,194.md,9,7,0,2,0
Markdown,md/117.md,117.md,17,13,0,4,0
Markdown,md/107.md,107.md,24,20,0,4,0
