Language,Location,Filename,Lines,Code,Comments,Blanks,Complexity
License,LICENSE,LICENSE,21,17,0,4,0
gitignore,.gitignore,.gitignore,1,1,0,0,0
Markdown,README.md,README.md,62,59,0,3,0
Markdown,MD/算法-数组-滑动窗口-最小连续子数组.md,算法-数组-滑动窗口-最小连续子数组.md,27,24,0,3,0
Markdown,MD/Web框架-Spring.md,Web框架-Spring.md,60,42,0,18,0
Markdown,MD/微服务-服务配置中心.md,微服务-服务配置中心.md,9,5,0,4,0
Markdown,MD/分布式-一致性hash.md,分布式-一致性hash.md,63,34,0,29,0
Markdown,MD/算法-数组-归并排序-合并有序数组.md,算法-数组-归并排序-合并有序数组.md,41,32,0,9,0
Markdown,MD/算法-二叉树-递归-二叉树反转.md,算法-二叉树-递归-二叉树反转.md,34,30,0,4,0
Markdown,MD/算法-链表-双指针-删除倒数第n个.md,算法-链表-双指针-删除倒数第n个.md,25,21,0,4,0
Markdown,MD/系统设计-高并发抢红包.md,系统设计-高并发抢红包.md,28,20,0,8,0
Markdown,MD/分布式-CAP理论.md,分布式-CAP理论.md,21,14,0,7,0
Markdown,MD/Java基础-集合.md,Java基础-集合.md,34,25,0,9,0
Markdown,MD/微服务-服务注册与发现.md,微服务-服务注册与发现.md,18,12,0,6,0
Markdown,MD/Java基础-多线程.md,Java基础-多线程.md,229,177,0,52,0
Markdown,MD/秒杀架构.md,秒杀架构.md,59,47,0,12,0
Markdown,MD/数据库-MySQL.md,数据库-MySQL.md,100,70,0,30,0
Markdown,MD/算法-数组-对撞指针-最大蓄水.md,算法-数组-对撞指针-最大蓄水.md,23,20,0,3,0
Markdown,MD/分布式-事务.md,分布式-事务.md,79,50,0,29,0
Markdown,MD/通用基础-排序算法.md,通用基础-排序算法.md,34,21,0,13,0
Markdown,MD/Java基础-IO.md,Java基础-IO.md,41,24,0,17,0
Markdown,MD/分布式-协调器.md,分布式-协调器.md,23,14,0,9,0
Markdown,MD/通用基础-网络通信协议.md,通用基础-网络通信协议.md,63,45,0,18,0
Markdown,MD/算法-数组-快速排序-第k大个数.md,算法-数组-快速排序-第k大个数.md,67,56,0,11,0
Markdown,MD/算法-数据结构-LRU淘汰算法.md,算法-数据结构-LRU淘汰算法.md,52,44,0,8,0
Markdown,MD/分布式-ID生成方式.md,分布式-ID生成方式.md,41,26,0,15,0
Markdown,MD/分布式-消息队列.md,分布式-消息队列.md,63,40,0,23,0
Markdown,MD/微服务-服务容错保护.md,微服务-服务容错保护.md,42,32,0,10,0
Markdown,MD/算法-动态规划-连续子数组最大和.md,算法-动态规划-连续子数组最大和.md,44,39,0,5,0
Markdown,MD/数据库-Redis.md,数据库-Redis.md,91,62,0,29,0
Markdown,MD/通用基础-设计模式.md,通用基础-设计模式.md,54,37,0,17,0
Markdown,MD/算法-链表-反转链表-链表相加.md,算法-链表-反转链表-链表相加.md,56,43,0,13,0
Markdown,MD/分布式-锁.md,分布式-锁.md,92,67,0,25,0
Markdown,MD/Java基础-JVM原理.md,Java基础-JVM原理.md,178,121,0,57,0
Markdown,MD/微服务-网关.md,微服务-网关.md,24,16,0,8,0
Markdown,MD/通用基础-操作系统.md,通用基础-操作系统.md,19,15,0,4,0
