Language,Location,Filename,Lines,Code,Comments,Blanks,Complexity
XML,.idea/codeStyles/codeStyleConfig.xml,codeStyleConfig.xml,5,5,0,0,0
Markdown,README.md,README.md,621,470,0,151,0
Markdown,docs/idea/知识星球.md,知识星球.md,46,23,0,23,0
Markdown,docs/idea/资料.md,资料.md,39,20,0,19,0
Markdown,docs/mq/重复消费、顺序消费、分布式事务.md,重复消费、顺序消费、分布式事务.md,324,177,0,147,0
Markdown,docs/creative/彩蛋.md,彩蛋.md,9,5,0,4,0
Markdown,docs/mq/消息队列基础.md,消息队列基础.md,278,137,0,141,0
Markdown,docs/coderLife/风雨十年从毕业到技术专家我做了啥.md,风雨十年从毕业到技术专家我做了啥.md,259,130,0,129,0
Markdown,docs/basics/HashMap.md,HashMap.md,314,170,0,144,0
Markdown,docs/redis/布隆过滤器(BloomFilter).md,布隆过滤器(BloomFilter).md,201,118,0,83,0
Markdown,docs/idea/idea.md,idea.md,149,86,0,63,0
Markdown,docs/idea/电子书.md,电子书.md,285,206,0,79,0
Markdown,docs/coderLife/教你在服务器搭建个人面试项目.md,教你在服务器搭建个人面试项目.md,279,148,0,131,0
Markdown,docs/coderLife/写作一个月在感恩节对大家说的话.md,写作一个月在感恩节对大家说的话.md,95,51,0,44,0
Markdown,docs/creative/《吐血整理》十年风雨技术人的书单整理.md,《吐血整理》十年风雨技术人的书单整理.md,790,458,0,332,0
Markdown,docs/creative/顶级程序员的百宝箱.md,顶级程序员的百宝箱.md,450,243,0,207,0
Markdown,docs/redis/集群高可用、哨兵、持久化、LRU.md,集群高可用、哨兵、持久化、LRU.md,293,150,0,143,0
Markdown,docs/redis/课代表总结.md,课代表总结.md,63,33,0,30,0
Markdown,docs/mq/RocketMQ.md,RocketMQ.md,544,295,0,249,0
Markdown,docs/coderLife/敖丙用20行代码拿了比赛冠军.md,敖丙用20行代码拿了比赛冠军.md,248,125,0,123,0
Markdown,docs/coderLife/记一次差点害敖丙丢工作的的线上P0事故.md,记一次差点害敖丙丢工作的的线上P0事故.md,389,247,0,142,0
Markdown,docs/redis/秒杀系统设计.md,秒杀系统设计.md,288,147,0,141,0
Markdown,docs/redis/Redis基础.md,Redis基础.md,146,74,0,72,0
Markdown,docs/redis/缓存击穿、雪崩、穿透.md,缓存击穿、雪崩、穿透.md,150,74,0,76,0
Markdown,docs/redis/Redis常见面试题.md,Redis常见面试题.md,508,258,0,250,0
Markdown,docs/redis/分布式锁、并发竞争、双写一致性.md,分布式锁、并发竞争、双写一致性.md,286,153,0,133,0
