Language,Location,Filename,Lines,Code,Comments,Blanks,Complexity
Markdown,02.线程的状态转换以及基本操作/线程状态转换以及基本操作.md,线程状态转换以及基本操作.md,255,196,0,59,0
Markdown,26.大白话说java并发工具类-Semaphore，Exchanger/大白话说java并发工具类-Semaphore，Exchanger.md,大白话说java并发工具类-Semaphore，Exchanger.md,192,140,0,52,0
Markdown,22.线程池之ScheduledThreadPoolExecutor/线程池之ScheduledThreadPoolExecutor.md,线程池之ScheduledThreadPoolExecutor.md,199,146,0,53,0
Markdown,01.并发编程的优缺点/并发编程的优缺点.md,并发编程的优缺点.md,124,92,0,32,0
Markdown,10.彻底理解ReentrantLock/彻底理解ReentrantLock.md,彻底理解ReentrantLock.md,101,78,0,23,0
Markdown,09.深入理解AbstractQueuedSynchronizer(AQS)/深入理解AbstractQueuedSynchronizer(AQS).md,深入理解AbstractQueuedSynchronizer(AQS).md,539,413,0,126,0
Markdown,19.并发容器之BlockingQueue/并发容器之BlockingQueue.md,并发容器之BlockingQueue.md,108,54,0,54,0
Markdown,21.线程池ThreadPoolExecutor实现原理/线程池ThreadPoolExecutor实现原理.md,线程池ThreadPoolExecutor实现原理.md,144,104,0,40,0
Markdown,14.并发容器之ConcurrentHashMap(JDK 1.8版本)/并发容器之ConcurrentHashMap(JDK 1.8版本).md,并发容器之ConcurrentHashMap(JDK 1.8版本).md,759,619,0,140,0
Markdown,25.大白话说java并发工具类-CountDownLatch，CyclicBarrier/大白话说java并发工具类-CountDownLatch，CyclicBarrier.md,大白话说java并发工具类-CountDownLatch，CyclicBarrier.md,177,129,0,48,0
Markdown,24.Java中atomic包中的原子操作类总结/Java中atomic包中的原子操作类总结.md,Java中atomic包中的原子操作类总结.md,225,149,0,76,0
Markdown,05.彻底理解volatile/java关键字---volatile.md,java关键字---volatile.md,134,84,0,50,0
Markdown,11.深入理解读写锁ReentrantReadWriteLock/深入理解读写锁ReentrantReadWriteLock.md,深入理解读写锁ReentrantReadWriteLock.md,208,183,0,25,0
Markdown,15.并发容器之ConcurrentLinkedQueue/并发容器之ConcurrentLinkedQueue.md,并发容器之ConcurrentLinkedQueue.md,309,186,0,123,0
Markdown,07.三大性质总结：原子性、可见性以及有序性/三大性质总结：原子性、可见性以及有序性.md,三大性质总结：原子性、可见性以及有序性.md,116,84,0,32,0
Markdown,23.FutureTask基本操作总结/FutureTask基本操作总结.md,FutureTask基本操作总结.md,54,29,0,25,0
Markdown,13.LockSupport工具/LockSupport工具.md,LockSupport工具.md,63,46,0,17,0
Markdown,README.md,README.md,154,74,0,80,0
Markdown,17.并发容器之ThreadLocal/并发容器之ThreadLocal.md,并发容器之ThreadLocal.md,432,319,0,113,0
Markdown,16.并发容器之CopyOnWriteArrayList/并发容器之CopyOnWriteArrayList.md,并发容器之CopyOnWriteArrayList.md,120,77,0,43,0
Markdown,12.详解Condition的await和signal等待通知机制/详解Condition的await和signal等待通知机制.md,详解Condition的await和signal等待通知机制.md,328,247,0,81,0
Markdown,04.彻底理解synchronized/java关键字---synchronized.md,java关键字---synchronized.md,243,145,0,98,0
Markdown,08.初识Lock与AbstractQueuedSynchronizer(AQS)/初识Lock与AbstractQueuedSynchronizer(AQS).md,初识Lock与AbstractQueuedSynchronizer(AQS).md,246,180,0,66,0
Markdown,03.java内存模型以及happens-before规则/Java内存模型以及happens-before.md,Java内存模型以及happens-before.md,145,89,0,56,0
Markdown,18.一篇文章，从源码深入详解ThreadLocal内存泄漏问题/一篇文章，从源码深入详解ThreadLocal内存泄漏问题.md,一篇文章，从源码深入详解ThreadLocal内存泄漏问题.md,415,304,0,111,0
Markdown,20.并发容器之ArrayBlockingQueue和LinkedBlockingQueue实现原理详解/并发容器之ArrayBlockingQueue和LinkedBlockingQueue实现原理详解.md,并发容器之ArrayBlockingQueue和LinkedBlockingQueue实现原理详解.md,265,205,0,60,0
Markdown,06.你以为你真的了解final吗？/java关键字--final.md,java关键字--final.md,297,196,0,101,0
Markdown,27.一篇文章，让你彻底弄懂生产者--消费者问题/一篇文章，让你彻底弄懂生产者--消费者问题.md,一篇文章，让你彻底弄懂生产者--消费者问题.md,726,558,0,168,0
