Language,Location,Filename,Lines,Code,Comments,Blanks,Complexity
Markdown,1.13 Java还是C++.md,1.13 Java还是C++.md,11,7,0,4,0
Markdown,16.10 练习.md,16.10 练习.md,8,4,0,4,0
Markdown,10.11 练习.md,10.11 练习.md,21,11,0,10,0
Markdown,2.8 注释和嵌入文档.md,2.8 注释和嵌入文档.md,174,111,0,63,0
Markdown,第11章 运行期类型鉴定.md,第11章 运行期类型鉴定.md,6,4,0,2,0
Markdown,12.6 练习.md,12.6 练习.md,9,7,0,2,0
Markdown,9.9 总结.md,9.9 总结.md,7,4,0,3,0
Markdown,1.7 对象的创建和存在时间.md,1.7 对象的创建和存在时间.md,81,43,0,38,0
Markdown,15.8 远程方法.md,15.8 远程方法.md,214,152,0,62,0
Markdown,14.6 总结.md,14.6 总结.md,29,16,0,13,0
Markdown,6.10 总结.md,6.10 总结.md,8,4,0,4,0
Markdown,14.5 回顾runnable.md,14.5 回顾runnable.md,201,173,0,28,0
Markdown,1.5 继承：重新使用接口.md,1.5 继承：重新使用接口.md,25,13,0,12,0
Markdown,11.5 练习.md,11.5 练习.md,14,8,0,6,0
Markdown,7.1 上溯造型.md,7.1 上溯造型.md,117,96,0,21,0
Markdown,SUMMARY.md,SUMMARY.md,164,162,0,2,0
Markdown,1.4 方案的重复使用.md,1.4 方案的重复使用.md,11,6,0,5,0
Markdown,2.1 用句柄操纵对象.md,2.1 用句柄操纵对象.md,19,12,0,7,0
Markdown,12.1 传递句柄.md,12.1 传递句柄.md,83,73,0,10,0
Markdown,10.8 压缩.md,10.8 压缩.md,228,185,0,43,0
Markdown,8.3 枚举器（反复器）.md,8.3 枚举器（反复器）.md,135,105,0,30,0
Markdown,第16章 设计范式.md,第16章 设计范式.md,9,5,0,4,0
Markdown,5.3 接口与实现.md,5.3 接口与实现.md,29,20,0,9,0
Markdown,3.4 练习.md,3.4 练习.md,7,4,0,3,0
Markdown,5.5 总结.md,5.5 总结.md,17,10,0,7,0
Markdown,10.4 File类.md,10.4 File类.md,282,242,0,40,0
Markdown,9.2 违例的捕获.md,9.2 违例的捕获.md,284,221,0,63,0
Markdown,17.3 复杂性理论.md,17.3 复杂性理论.md,311,295,0,16,0
Markdown,第12章 传递和返回对象.md,第12章 传递和返回对象.md,8,4,0,4,0
Markdown,17.4 总结.md,17.4 总结.md,4,2,0,2,0
Markdown,2.3 绝对不要清除对象.md,2.3 绝对不要清除对象.md,54,38,0,16,0
Markdown,14.4 优先级.md,14.4 优先级.md,457,404,0,53,0
Markdown,8.1 数组.md,8.1 数组.md,191,156,0,35,0
Markdown,16.3 模拟垃圾回收站.md,16.3 模拟垃圾回收站.md,126,110,0,16,0
Markdown,7.3 覆盖与过载.md,7.3 覆盖与过载.md,48,37,0,11,0
Markdown,7.4 抽象类和方法.md,7.4 抽象类和方法.md,111,88,0,23,0
Markdown,附录B 对比C++和Java.md,附录B 对比C++和Java.md,204,124,0,80,0
Markdown,4.6 总结.md,4.6 总结.md,7,4,0,3,0
Markdown,16.1 范式的概念.md,16.1 范式的概念.md,73,52,0,21,0
Markdown,16.6 多重派遣.md,16.6 多重派遣.md,257,220,0,37,0
Markdown,8.8 总结.md,8.8 总结.md,17,9,0,8,0
Markdown,第15章 网络编程.md,第15章 网络编程.md,11,6,0,5,0
Markdown,7.5 接口.md,7.5 接口.md,306,244,0,62,0
Markdown,9.4 创建自己的违例.md,9.4 创建自己的违例.md,155,135,0,20,0
Markdown,11.3 反射：运行期类信息.md,11.3 反射：运行期类信息.md,181,160,0,21,0
JSON,book.json,book.json,61,29,0,32,0
Markdown,9.5 违例的限制.md,9.5 违例的限制.md,95,79,0,16,0
Markdown,第7章 多态性.md,第7章 多态性.md,10,5,0,5,0
Markdown,附录C Java编程规则.md,附录C Java编程规则.md,91,50,0,41,0
Markdown,附录A 使用非JAVA代码.md,附录A 使用非JAVA代码.md,929,668,0,261,0
Markdown,15.6 Java与CGI的沟通.md,15.6 Java与CGI的沟通.md,724,641,0,83,0
Markdown,第4章 初始化和清除.md,第4章 初始化和清除.md,8,4,0,4,0
Markdown,17.1 文字处理.md,17.1 文字处理.md,818,745,0,73,0
Markdown,9.10 练习.md,9.10 练习.md,9,5,0,4,0
Markdown,15.3 服务多个客户.md,15.3 服务多个客户.md,180,163,0,17,0
Markdown,8.2 集合.md,8.2 集合.md,189,150,0,39,0
Markdown,9.7 构建器.md,9.7 构建器.md,108,89,0,19,0
Markdown,附录F 推荐读物.md,附录F 推荐读物.md,57,47,0,10,0
Markdown,第1章 对象入门.md,第1章 对象入门.md,17,9,0,8,0
Markdown,17.2 方法查找工具.md,17.2 方法查找工具.md,179,168,0,11,0
Markdown,1.6 多态对象的互换使用.md,1.6 多态对象的互换使用.md,66,44,0,22,0
Markdown,2.5 方法、自变量和返回值.md,2.5 方法、自变量和返回值.md,56,35,0,21,0
Markdown,第3章 控制程序流程.md,第3章 控制程序流程.md,8,3,0,5,0
Markdown,4.7 练习.md,4.7 练习.md,13,7,0,6,0
Markdown,1.8 违例控制：解决错误.md,1.8 违例控制：解决错误.md,9,5,0,4,0
Markdown,第8章 对象的容纳.md,第8章 对象的容纳.md,14,8,0,6,0
Markdown,7.7 构建器和多形性.md,7.7 构建器和多形性.md,288,235,0,53,0
Markdown,9.3 标准Java违例.md,9.3 标准Java违例.md,66,45,0,21,0
Markdown,第14章 多线程.md,第14章 多线程.md,10,5,0,5,0
Markdown,第6章 类再生.md,第6章 类再生.md,13,6,0,7,0
Markdown,8.5 排序.md,8.5 排序.md,186,162,0,24,0
Markdown,10.2 增添属性和有用的接口.md,10.2 增添属性和有用的接口.md,125,61,0,64,0
Markdown,6.9 初始化和类装载.md,6.9 初始化和类装载.md,68,54,0,14,0
Markdown,README.md,README.md,20,10,0,10,0
Markdown,9.6 用finally清除.md,9.6 用finally清除.md,223,184,0,39,0
Markdown,第10章 Java IO系统.md,第10章 Java IO系统.md,10,5,0,5,0
Markdown,9.1 基本违例.md,9.1 基本违例.md,33,20,0,13,0
Markdown,10.9 对象序列化.md,10.9 对象序列化.md,796,684,0,112,0
Markdown,16.2 观察器范式.md,16.2 观察器范式.md,104,93,0,11,0
Markdown,9.8 违例匹配.md,9.8 违例匹配.md,71,50,0,21,0
Markdown,16.4 改进设计.md,16.4 改进设计.md,425,355,0,70,0
Markdown,5.1 包：库单元.md,5.1 包：库单元.md,355,268,0,87,0
gitignore,.gitignore,.gitignore,16,6,7,3,0
Markdown,2.9 编码样式.md,2.9 编码样式.md,22,16,0,6,0
Markdown,8.9 练习.md,8.9 练习.md,17,9,0,8,0
Markdown,附录D 性能.md,附录D 性能.md,229,135,0,94,0
Markdown,10.7 Java 1.1的IO流.md,10.7 Java 1.1的IO流.md,375,275,0,100,0
Markdown,7.10 练习.md,7.10 练习.md,9,5,0,4,0
Markdown,2.7 我们的第一个Java程序.md,2.7 我们的第一个Java程序.md,73,51,0,22,0
Markdown,11.1 对RTTI的需要.md,11.1 对RTTI的需要.md,462,371,0,91,0
Markdown,3.3 总结.md,3.3 总结.md,4,2,0,2,0
Markdown,10.3 本身的缺陷：RandomAccessFile.md,10.3 本身的缺陷：RandomAccessFile.md,9,5,0,4,0
Markdown,3.2 执行控制.md,3.2 执行控制.md,571,457,0,114,0
Markdown,15.9 总结.md,15.9 总结.md,7,4,0,3,0
Markdown,第5章 隐藏实施过程.md,第5章 隐藏实施过程.md,12,6,0,6,0
Markdown,2.11 练习.md,2.11 练习.md,10,5,0,5,0
Markdown,5.2 Java访问指示符.md,5.2 Java访问指示符.md,167,121,0,46,0
Markdown,10.6 StreamTokenizer.md,10.6 StreamTokenizer.md,216,194,0,22,0
Markdown,17.5 练习.md,17.5 练习.md,9,5,0,4,0
Markdown,10.1 输入和输出.md,10.1 输入和输出.md,160,84,0,76,0
Markdown,4.2 方法过载.md,4.2 方法过载.md,435,349,0,86,0
Markdown,1.12 分析和设计.md,1.12 分析和设计.md,74,38,0,36,0
Markdown,6.8 final关键字.md,6.8 final关键字.md,209,156,0,53,0
Markdown,16.8 RTTI真的有害吗.md,16.8 RTTI真的有害吗.md,82,66,0,16,0
Markdown,15.2 套接字.md,15.2 套接字.md,178,142,0,36,0
Markdown,写在前面的话.md,写在前面的话.md,22,12,0,10,0
Markdown,第17章 项目.md,第17章 项目.md,5,3,0,2,0
Markdown,6.4 到底选择合成还是继承.md,6.4 到底选择合成还是继承.md,53,42,0,11,0
Markdown,6.7 上溯造型.md,6.7 上溯造型.md,43,30,0,13,0
Markdown,15.10 练习.md,15.10 练习.md,15,8,0,7,0
Markdown,6.3 合成与继承的结合.md,6.3 合成与继承的结合.md,221,185,0,36,0
Markdown,第2章 一切都是对象.md,第2章 一切都是对象.md,9,4,0,5,0
Markdown,7.9 总结.md,7.9 总结.md,9,4,0,5,0
Markdown,引言.md,引言.md,267,144,0,123,0
Markdown,3.1 使用Java运算符.md,3.1 使用Java运算符.md,1211,1028,0,183,0
Markdown,1.1 抽象的进步.md,1.1 抽象的进步.md,25,12,0,13,0
Markdown,5.4 类访问.md,5.4 类访问.md,92,66,0,26,0
Markdown,14.7 练习.md,14.7 练习.md,20,10,0,10,0
Markdown,6.1 合成的语法.md,6.1 合成的语法.md,136,114,0,22,0
Markdown,11.2 RTTI语法.md,11.2 RTTI语法.md,77,62,0,15,0
Markdown,15.7 用JDBC连接数据库.md,15.7 用JDBC连接数据库.md,288,225,0,63,0
Markdown,6.2 继承的语法.md,6.2 继承的语法.md,143,110,0,33,0
Markdown,8.6 通用集合库.md,8.6 通用集合库.md,6,3,0,3,0
Markdown,2.4 新建数据类型：类.md,2.4 新建数据类型：类.md,81,55,0,26,0
Markdown,16.9 总结.md,16.9 总结.md,29,15,0,14,0
Markdown,7.2 深入理解.md,7.2 深入理解.md,223,177,0,46,0
Markdown,12.3 克隆的控制.md,12.3 克隆的控制.md,279,255,0,24,0
Markdown,14.2 共享有限的资源.md,14.2 共享有限的资源.md,537,478,0,59,0
Markdown,12.2 制作本地副本.md,12.2 制作本地副本.md,486,437,0,49,0
Markdown,14.1 反应灵敏的用户界面.md,14.1 反应灵敏的用户界面.md,588,511,0,77,0
Markdown,2.2 所有对象都必须创建.md,2.2 所有对象都必须创建.md,89,54,0,35,0
Markdown,16.5 抽象的应用.md,16.5 抽象的应用.md,108,86,0,22,0
Markdown,4.1 用构建器自动初始化.md,4.1 用构建器自动初始化.md,65,48,0,17,0
Markdown,1.11 Java和因特网.md,1.11 Java和因特网.md,97,49,0,48,0
Markdown,14.3 堵塞.md,14.3 堵塞.md,546,473,0,73,0
Markdown,10.10 总结.md,10.10 总结.md,8,5,0,3,0
Markdown,4.3 清除：收尾和垃圾收集.md,4.3 清除：收尾和垃圾收集.md,142,107,0,35,0
Markdown,10.5 IO流的典型应用.md,10.5 IO流的典型应用.md,334,263,0,71,0
Markdown,6.5 protected.md,6.5 protected.md,27,21,0,6,0
Markdown,4.4 成员初始化.md,4.4 成员初始化.md,397,325,0,72,0
Markdown,1.9 多线程.md,1.9 多线程.md,11,6,0,5,0
Markdown,15.4 数据报.md,15.4 数据报.md,157,142,0,15,0
Markdown,6.11 练习.md,6.11 练习.md,10,5,0,5,0
Markdown,1.2 对象的接口.md,1.2 对象的接口.md,26,15,0,11,0
Markdown,4.5 数组初始化.md,4.5 数组初始化.md,314,257,0,57,0
Markdown,第9章 违例差错控制.md,第9章 违例差错控制.md,17,9,0,8,0
Markdown,1.3 实现方案的隐藏.md,1.3 实现方案的隐藏.md,18,9,0,9,0
Markdown,8.4 集合的类型.md,8.4 集合的类型.md,404,326,0,78,0
Markdown,第13章 创建窗口和程序片.md,第13章 创建窗口和程序片.md,4798,4429,0,369,0
Markdown,附录E 关于垃圾收集的一些话.md,附录E 关于垃圾收集的一些话.md,38,19,0,19,0
Markdown,12.4 只读类.md,12.4 只读类.md,265,233,0,32,0
Markdown,16.7 访问器范式.md,16.7 访问器范式.md,265,229,0,36,0
Markdown,5.6 练习.md,5.6 练习.md,18,9,0,9,0
Markdown,12.5 总结.md,12.5 总结.md,14,9,0,5,0
Markdown,2.10 总结.md,2.10 总结.md,5,2,0,3,0
Markdown,11.4 总结.md,11.4 总结.md,8,5,0,3,0
Markdown,1.10 永久性.md,1.10 永久性.md,6,3,0,3,0
Markdown,8.7 新集合.md,8.7 新集合.md,1532,1202,0,330,0
Markdown,15.1 机器的标识.md,15.1 机器的标识.md,90,61,0,29,0
Markdown,7.8 通过继承进行设计.md,7.8 通过继承进行设计.md,121,87,0,34,0
Markdown,6.6 累积开发.md,6.6 累积开发.md,10,6,0,4,0
Markdown,2.6 构建Java程序.md,2.6 构建Java程序.md,93,58,0,35,0
Markdown,15.5 一个Web应用.md,15.5 一个Web应用.md,391,333,0,58,0
Markdown,7.6 内部类.md,7.6 内部类.md,977,817,0,160,0
